9 9
 ********
 *   ****
 * * ****
 * * ****
 * * ****
 * * ****
   * ****
   *     
******** 
