11 20
 *******************
 *******************
                   *
****** *********** *
                 * *
**************** * *
                 * *
****************** *
                   *
 *******************
                    
******************* 
